####################
#..I..............P#
#........I.....I...#
#....#####.......I.#
#..............I...#
####################